AA_3-letter	AA	Property
Arg	R	Basic
Lys	K	Basic
His	H	Basic
Glu	E	Acidic
Asp	D	Acidic
Gly	G	Polar
Ser	S	Polar
Asn	N	Polar
Thr	T	Polar
Gln	Q	Polar
Cys	C	Polar
Tyr	Y	Polar
Ala	A	Hydrophobic
Val	V	Hydrophobic
Met	M	Hydrophobic
Ile	I	Hydrophobic
Pro	P	Hydrophobic
Leu	L	Hydrophobic
Trp	W	Hydrophobic
Phe	F	Hydrophobic
